aa		arriba
aai		esposa
aaide		producir un árbol en abundancia, masticar
aairede		tener esposa
aama		hermano (del hombre)
aare		largo, lejos, largo rato
abi		cuerpo
abi iinote		ser infame
abi jeedate		resignarse
abido		de regreso
abimo		en el cuerpo, forma
abina izirede		sentir dolor en el cuerpo
afai		río arriba
afekodo		por la rendija, ranura
aguide		colgar
aguidote		mecer
aidode		cosechar tubérculos (yuca, ñame...)
aimetaite		tener hambre
aiñidima		dios
airiji		casabe
airiki		canasto lleno de yuca
aiyoko		casa grande (maloca)
aiberite		aprovechar, disfrutar
aimade		pescar
aintajaide		ir a pescar
akatate		mostrar, exhibir
akínomona		desde entonces, desde ahí
amegi		tronco grande
amena		árbol
amigi		fruto del almendro
amio		bejuco del almendro
ana		lado de abajo, fondo, suelo
anafebei		en la parte de abajo
anamo		debajo, en el fondo
ari		arriba, norte
atide		traer
baaide		morir
baite		encontrar
bakade		manchar la boca
banofe		hígado
barede		eructar
barenote		expulsar con el eructo, crear mediante el eructo
beeide		tostar
beno		aquí
bie		esto, este, esta
binie		tierra
bite		venir
biya		venida
biyama		tío materno
bigi		macana
bitadate		acostarse (P1)
bofedaite		estar herido
bonode		hacer fuego
boocle		arder un fuego
borarede		ser amarillo
boride		relampaguear
borinaite		tener gripa
boriño		catarro, gripa
boza		bifurcación
bue		¿qué cosa?
buena jaaide		ser desconocido
bueri		¿por qué?
buiñode		recoger agua en un recipiente, coger peces
buu		¿quién?
daa		siempre
daakaiño		en el mismo momento, en el mismo instante
daane		otra vez
daanomo		en un mismo lugar
daarui		el mismo día
dabekuiro		cinco
dabekuiro emodomo daje		seis
dabekuiro emodomo dajeámani		ocho
dclbekuiro emodomo mena		siete
dabekuiro emodomo nagaámaga		nueve
dabekuiromie		cinco hombres
daje		uno
dajeámoni		tres
dakaiño		una vez, de vez en cuando
dama		un (hombre) solo
dama		seguido de un verbo finito: 'no importa que'
damade		estar solo
daruiamani		tres días
denode		toparse con algo / alguien
dete		rajar, destripar
diga		antepuesto al nombre: mucho, mucha
diga		pospuesto al nombre: con
digakino		muchas novedades
diirue jiko		avispa roja
dine		allí, allí, donde
dino		allí, allí, ese lugar
dirue		sangre
diue		tabaco
dobede		machacar yuca
dofokoni		en el comienzo
domeko		morada
doode		hablar, decir
dozide		transformar
duerede		ser pobre, desgraciado, estar triste
dute		mambear
duye		mambe
ebe		¡oye!, jay!
ebekotaide		atreverse
ebire		bonito
eede		llorar
eei		mamá (P2)
eeikaño		tía política
eeiñaiño		la mayor
eeifio		madre
eenota		custodiar
eiri namaki		antepasados
eirue jitotiai		antepasados
ekade		dar de comer
ekaiai		palo podrido
ekonote		abrir, destapar
enaize		nieto
eo		mucho, muy
erai		nombre de un baile
ere		palma de caraná (término genérico)
erei		peine de caraná para techar
ererite		ir por hojas de caraná
erodate		mirar, fijarse
erodo		primero
eruaide		mirar
etoño		pájaro carpintero
evuño		hermana (de una mujer)
ezarokaide		resplandecer
faijide		clavar, enterrar
fairide		flotar
fairiji		caldo de yuca
fairiote		responder, contestar
faite		extender hoja de platanillo, colocar red, botar
fakadote		advertir
fakai		tiempo, época
farede		ser grasoso, ser gordo
fate		azotar, pegar
feeide		barbasquear (intrans.)
feeirede		ser difícil
feekco		despacio, lento
fekade		repartir
fekuize		despacio, con cuidado
fete		barbasquear (trans.)
fiebide		quedarse
fiede		dejar
fiemona		verano, año
fiiide		acostarse en hamaca
fikaiño		torcaza
finobite		arreglar para la fiesta
finode		preparar, hacer
finorite		consumir plantas poderosas
finoyino		lugar para prepararse
fivui		luna, mes
foo		adentro
fue		boca, lado, orilla
fuedo		por la boca, el lado, la orilla
fuekoni		en la orilla, orilla
fueote		aprender
fuiri		rio abajo
gaade		mermar, secar
gairide		descansar en grupo, estar reunidos
gaitade		agarrar, atrapar, posesionarse
gononokai		cañaa de azúcar
guifide		saciarse
guite		comer (P3)
guiye		comida
gwate		moler golpeando, machacar
ia		pero
iaiñuai		las dos (mujeres)
ibaide (¿?)		cerrar, trancar
ibe		hoja
ie		su (de él o de ella)
ie jirari		por esa razón
ie meeino		después de eso
iekoni		en ese lugar, en eso, cerca de eso
iemei		¿qué hay de ...?
iemo		en eso, pero
iena		de eso
ieri		por eso
ieza		de manera que
ieze		así, después de eso
igomei		lugar por donde sale el sol, desfiladero, zanja
Ikato		El Encanto
ikide		regañar
ikino		noticia
ikirite		enojarse
imie		ese hombre
inaida		pintadillo
inomo		allí, en ese lugar
iñede		no hay, no existe
iobide		estar agradecido, contento
irai		fogón, candela
irea		conjunto de trampas
iride		acarrear, cargar
ite		estar, vivir
ite		dar
iyaikomini		jefes, ancianos, líderes
iyaima		jefe
iye		rio pequeño
iye ana		fondo de río
iyi		chagra
iyoki		afrecho, bagazo
iyuircde		ser temible, impresionante, extenuante
izido		diente
izikoda		horquilla
izirafe		cernidor
izirede		doler
izo		tío paterno
izoide		ser así, parecer
I		-
iaizai		sal de monte
ibaide		cerrar
iduide		exprimir
iede		meter
ifode		encabezar
ifogi		cabeza
iiio		hermano (de una mujer)
iigai		mito
ikáre		mañana
ikáre ie are		pasado mañana
iko		algún día
imokiño		ortiga, pringamosa
imuide		mezclar ceniza con coca
inarako		exprimidor de yuca (matafrío, sebucán)
ini		esposo
inirede		tener esposo
inimi		vestido
inide		dormir
iniyino		lugar donde dormir
iraiai		enfermedad
iraide		juntar
irarede		estar enfermo
jaa		bien, de acuerdo
jaaide		ir
jaanote		callar, ocultar
jadine		donde, cerca de, hacia
jadino		allí (cerca del oyente)
jae		hace rato, antes
jai		ya, ahora mismo
jaibikiño		albahaca
jaieragima		antepasado
jaitade		cortar, cercenar
jaiabe		remo
jaigabi		cahuana
jaikirite		espesar
jaikuide		mezclar
jaite		revolver, remar
jaka		siempre, realmente
jakaiji		ñame (tubérculo)
jamai		solamente
janore		pequeño, poco
janorede		ser pequeño
janoza		niño pequeño, bebé
jarikina		rápido
jata		hacha de piedra
jazerede		sin ganas, sin ánimo
jaziki		selva, monte
jeeikite		parir, dar a luz
jemoirede		ser peligroso
jeniki		base, fondo, comienzo, origen
jenode		buscar
jerai		interior
jeraina feeide		tener diarrea
jetade		tocar, palpar
jidoro		planta de pintura negra
jifikogi		caimito (fruto)
jifikue rerama		zorro
jiguide		madurar frutas
jiibibiri		mambeadero
jiibie		coca
jiibigoi		pilón de coca
jiibikada		palo para majar coca
jiibikuiro		talego para cernir coca
jiide		caer en la trampa
jimeki		chontaduro (fruto)
jino		afuera
jiñora		arcilla, barro
jirazite		ser o estar pintado o rayado, coloreado
jirode		beber
jiroye		bebida
jiruruño		renacuajo
jitaide		necesitar
jitiramo		a la madrugada
jito		hijo
jitokomini		gente joven
jitoma		sol
jiza		hija
jizaiño		guama
jiai		también
jiaie		otro, otra (P4)
jiaikaiño		a veces, otra vez
jiaimie		otro (hombre)
jiaimona		el año entrante
jiaino		los otros
jiaivui		el mes entrante
jibuide		ver, visitar
jifai		suegro
jifaide		embriagarse con una sustancia alucinógena
jifaiño		suegra
jii		sí
jiide		curar con rezos
jiira		nombre de un rezo
jikadc		pedir
jikanote		preguntar
jikodate		aludir, anunciar, gritar
jinafona		de último/a
jinui		agua
jirikobu		racimo de uva caimarón
jiruireide		estar enamorado
jobaide		quemar
jofo		casa
jogobe		pecho
jokode		lavar
joodate		descansar, acostarse
jorai		lago, laguna
joreño		espíritu, imagen, retrato
juarede		ser demorado
juari		envuelto de yuca
jufidote		comentar, discutir
jufirede		ser fastidioso
juiyie		yuca brava
jurao		raíz, tubérculo
kaaide		revisar trampa
kai		nosotros
kaidide		no querer dar, mesquinar, defender
kaiñai		nosotras dos
kaintade		alegrarse, estar feliz
kaimaki		los nuestros
kaimarede		ser sabroso
kairikotaide		ser atrevido, imprudente
kaite		comer umarí
kakareide		escuchar, creer
kanode		ayudar
karide		comer hormigas
kazide		despertarse, levantarse, emerger
kidode		aplicar medicina tradicional
kikuetiko		vómito
kimaigoi		garganta
kinai		hamaca
kiode		ver, mirar
kiraiforo		hoja seca de yarumo
kirigai		canasto (genérico)
kiriruda		canasto grande
kiritikoi		canastico
kodade		ahumar
koko		nosotros dos
kome		ser humano
komeki		corazón
komini		hombres, gente
komuide		originarse, crearse
korebaide		blanquear como almidón
koregi amena		árbol del almidón, yuca
kue		yo/mi
kuiodo		loro coronado, loro hacha
kurairite		canto del loro coronado
kweeide		acabarse
kwetade		asechar, esperar, vigilar
maafaite		amenazar, desear la muerte de alguien
maite		ortigar
maijide		trabajar
mairide		ser fuerte, robusto
mameki		nombre
manode		curar
manoriraima		curandero
manoye		remedio
maraki		savia de bejuco
mare		bueno
marena		bien
mazaka		maní
meeidaite		avergonzar
meeinete		matar
meeino		después
meeiruite		sentir vergüenza
mena		dos
menade		ser dos
menarui		dos días
meniñote		abrazar, acariciar
mete		lamer
miide		indicar, señalar
miñie		ratón
mika		¿qué?, ¿qué cosa? (murui - El Encanto)
minika		¿qué?, ¿qué cosa? (muinane – La Chorrera)
mio		nuera
miriño		hermana (del hombre)
monide		estar con sensación de llenura, tener abundante comida
monifue tooiño		mascota del alimento
moniya amena		árbol de la abundancia
moo		padre, (también voc.) para dirigirse a un hombre joven
mooifo		vagina, vulva
moomao		los padres
moonaite		madurar
moto		mitad, medio
motokoni		en medio
mtlido		punta, final
muite		untarse, pintar
mutade		remojar casabe en un caldo
mutio		cordón umbilical
muzeji		cacao silvestre
naaiyi		dentro de un rato
naana		todos
nabai		amigo
naga		cada uno
nagaámaga		cuatro
nagaámagarui		cuatro días
nagajebekuiro		diez
nagakorie		cada casa (P5)
nagoberi		todo el pueblo
naidakaide		pararse con rapidez
naie		aquel, aquella, aquello
naiena		de aquello
naifodo		por el hueco
naimaki		ellos
naimie		él
naimerede		ser dulce
naina		ese árbol
naino		aquel lugar, allí
naiñaiño		ella
naiza		esa criatura
naiza iaimaiai		esos dos niños
naio		noche
nairai		gente, pueblo
naite		comer caña
najeri		todos
namaki		dueños
nano		primero, comienzo
navuiraite		ser sorprendido por la noche
neeizi		hormiga arriera
nekazi		umarí verde (fruto)
nemozi		umarí amarillo (fruto)
nete		colgar la hamaca
nia		todavía
nieze		¿de qué manera?
niraidate		moverse
nite		tejer, confeccionar, construir
niya		tejido, acción de tejer
nibaide		poder hacer
nie		¿cuál?
nie dinori		¿cuánto tiempo?
nifode		¿ser cómo?
niga		¿cuánto?
nigafue		¿cuánta novedad (hay)?
nigakino		¿cuánta noticia (hay)?
nii		¡a ver!, ¿dónde?
nikai		sueño, ensoñación
nikaide		soñar, ver en sueños
nikidote		codiciar, querer con ansia, luchar
nimairani		sabedores
nine		¿dónde?, ¿a dónde?
nino		¿dónde? (definido)
nirui		¿cuándo?, ¿qué día?
nofaiño		sapo
Nofidieño		Madre Piedra
Nofiko		La Chorrera
nogo		olla de barro
nokae		canoa
nokaido		tucán
nomedo		aguacate (fruto)
nooide		bañarse
nooirai		bañadero
ñaitade		doblar o encoger una pierna
ñaite		conversar
ñedode		luchar, bregar por alcanzar algo
ñekiro		fibra de cumare (chambira)
ñete		hacer
ñitade		oler, olfatear
ñuibira zuui		colador
o		tú
Odo		Eudocio
ofoma		ave
ofuai		aves, pájaros
oie		tuyo, tuya
okide		llamar, nominar
okuide		ordenar
okuidote		alistar
omakai		cola, rabo
omiko		ustedes dos (hombres)
omima		pez cheo
omiñoi		ustedes dos (mujeres)
omoi		ustedes
oni dine		hacia un lado
oogodo		banano (fruto)
oogoe		racimo de plátano
ore		¡oye!
ote		sacar, coger
raa		cosa
raaide		sentarse, estar sentado
raaize		bien
raao		bejuco, liana, raíz
raaote		cazar
raauaide		ir a cazar
rabekoro		cucurucho de hojas
radozi		ramita, palito
rafoda		hueco
rafoda komimafo		la cueva de los hombres
rafue		tradiciones, enseñanzas, ritual
raiñena		sin mencionar
raiñuai		provisiones
raite		decir
raitide		desyerbar
raimode		coger leña para el futuro suegro
rainadate		sentarse
rainade		sentar, colocar
raji		fruto redondo pequeño
ranino		fruta
rayari		porque dijo
reeigai		leña
reeiki		leño encendido
reribakui		flauta de Pan
riai		gente no indígena (y carijona)
riaiko		muslo, pierna
riama		hombre no indígena (y carijona)
riaño		mujer no indígena (y carijona)
ribeji		líquido amniótico
ribeño		placenta
riide		llegar
riño		mujer
rite		comer carne, pescado
riye		comida (carne, pescado)
rokode		cocinar
roziyi		piña
ruidoño		sabaleta
ruuide		asar, tostar
ruuika		es asado
tainode		partir un objeto (P6)
taino yote		mentir, engañar
takirafe		corva
takuiñote		elevar
taro		tarro
tejako		tosferina
tidade		hacer un andamio
tiede		derribar, tumbar
tifode		coser
tikonote		arrancar
tinode		cosechar frutos
tofe		soplador
tooi		mascota
totade		derramar agua
tubuji		daledale (tubérculo)
tutuko		sarampión
tuuide		estar abierto o destapado un hueco
uai		lenguaje, palabra
uaide		ir a traer
uaide		caer
uaidote		saludar, llamar
uede		estar cocido, tostado
ueñede		no estar cocido, no estar tostado
uigoji		lago turbio
uite		llevar
uiuikazidoma		gusano
uiyobefe		hoja de platanillo
uuizi		ojo
unao		bejuco de yagé
urue		niño
uruerede		tener hijos
urunaite		estar embarazada
uruiai, urutiko		niños
uuiñote		saber, conocer
uuri		tranquilo
uzu		abuelo (término vocativo)
uzuma		abuelo
uzuño		abuela
vete		cohabitar, copular
yaaide		partir
yegirede		ser complicado
yera		ambil
yeroda		tinaja
yite		comer frutas
yiiide		sostener algo en la mano
yikiai		pescado, cacería
yikitiko		mucho pescado
yikizi		carne
yizide		dar fruto
yoba		sábalo
yoebi		machete
yomeniko		arepa de yuca
yote		contar, narrar
yuaibite		venir a avisar
yuaide		ir a contar, decir
yunude		descargar, vaciar, madurar yuca
yurako		cólera
yuuide		tener diarrea
zaaide		terminar (intrans.)
zedade		esperar a alguien, cuidar algo
zefuirede		ser arduo o laborioso
zegode		curarse, mejorarse
zeride		empollar
zeroi		lugar limpio
zeroikoni		en el lugar limpio
zete		sacar fibra
zibegi		tiesto, budare
ziiruite		respetar
zirikoji		uva caimarona
ziabete		deslizar
zianote		brillar, destellar luces
zikii		nombre de una danza
zote		preparar casabe
zuitade		tener fiebre
zuui		cernidor, balay